zlo: tnx
cwi: lct vxu was
agf: dac fob
uqn: mik ygx yrg zpj
saf: ktw
qgs: vab vom heu rpz
pfp: ljo
qmv: ica jsm kxt mhx
kaj: swp zna
kkh: vdy drb cbd
vxj: sor was
bpy: out
ovx: out
nav: fft zrr
vnz: hin qhx kvv qef
mkk: vdw
uby: dfh rpz heu
ior: out
qxu: dcx xah zps
lmc: mqr etj
you: ghy ewl qxa lfk tsx ymp nio
zhj: etj uit mqr
gzu: abr tyj lfw
nbd: drb
zcj: bqe wka jht oya
zjk: jxp jcf
cah: hvt
inz: oar nsc
ewl: exu xhz
swp: rzt zly gwt
nnm: afe weo hny
utd: tza uiy flj
uce: out
xbq: tnx
tej: okq qij whl
gmc: wwq eiu gdg
mqs: hkt nao aej bbw
geh: ymg
enn: sch wrt
lwg: fff uqn
utk: rjt hny hzt
cve: tnx you ymg
jez: yvl uyz gbw scj
ptx: ymg
oez: iql zmv uce bpy
ssu: you
boi: hpp mix lah
air: gir xrh mhd ixn
bga: out
xvu: zsg
tza: hkm
bji: lxy
gdv: aqt xss
zdi: wru
vly: tfu tmi nis ihk
jvg: nha
txr: esm tyi zxc
sqv: aim
jxp: nha dnz vgj
ivc: dea cwn hmy
phr: whl
gwh: bhw
era: oas
zxc: har uqt bzj ekh lmc
aej: ghx vno
zpj: mng qmn
lfw: pwz ehp xkl zhj
nis: xfy quu
oas: tza flj
agv: smb vjm dvc
etj: uiz jig wwp agf lfa ewv eau uaa gzk wam rsf kfm tgs cwh jrq xsb rjz utk ieb xaj cby zco
fic: vab
hmy: tnx
exu: aej
vkl: ftz krm nvg
sch: sjx ipm
lhk: okq
zrr: bvr urh
dnr: wwq wru
vcq: cbd
yie: btv yar
nzh: qgs plb inq
iiq: vom vab rpz
fxh: bvr bqw bnt
zps: vab
mdf: xsj qhx kvv qef
ygg: lxy
kfm: uyc kkr yjk
jpj: heu rpz dfh vom
kkr: ndq saf
uiy: hkm zho kum bjz
ntx: eiu gdg
ouy: yrx ucd pfp
gwt: rzd ezv
ueb: smb vjm dvc
abr: xkl zhj kmi pwz ehp
huv: kvv qef xsj
scj: yfw
mjj: cll
ewv: odw wxr
ndv: vab vom dfh heu rpz
nao: ghx
dub: tnx ymg
rsf: hny hzt weo afe
mhf: you ymg tnx
ohl: hhk
qeb: csl rab nlq
mbz: uiy tza edj khm
psz: oez htv
itd: dvc vjm smb
ygx: qmn aim
xlq: iwd zdi
bpv: pbg dnr
wxl: cxk ndv iiq
jig: lcm
hkm: out
wzv: hpc jvi
fob: hmy cwn kxq dea
cwh: agd dac fob
ulh: gdg wwq
ldl: hbl cru
whl: era jqq jal mgp
qja: ozm
ztw: jup znc
mrp: you tnx
gnp: drb
taz: lfm zmf ldx zcy
odw: gft
irv: wru
xmm: wwq
azj: ngl vuq
aqy: nha dnz
qju: iqw mjj
fmq: xrh mhd ixn
uit: cwh agf tgs jrq gzk uiz wam wwp jig qeb nnm sol ewv lfa eau ieb cby xaj
txx: eiu wwq wru gdg
xoc: hpc xvu jvi vcl bpv
yjk: saf
cby: ouy iyi
edj: zho kum
ica: ntx kpy
xah: dfh
iyi: cpj ucd
rit: vuq jsc
mah: rzt gwt zly
hun: btv yar
mhd: rpz heu vom vab
inq: dfh heu vab vom
pvu: ary svu
mhx: ntx kpy
rzy: jgo
uyz: psz rwb
wzc: wru eiu
taw: iwd yog zdi zkn
qor: jcf ers jvg aqy
mzz: scj jgo uyz gbw yvl
rya: vno roc ghx
vsv: mhf gft cve
zhp: trg fft
ian: zcj
jip: egh
mzb: qhx
zcy: gzh inz jyv
cwn: you
nmk: zkn zdr iwd
uri: krm dlr ftz epe nvg
ndq: evu
qck: mrr tfc
nvg: cne
lft: mzc aar
xbn: uqn fff
btv: out
lvg: jmh cru
har: etj
nqw: dll
epe: ttn ikt xcj soc
hin: ugw lek rbb nig
tyj: xkl
qsh: evu geh ktw
agd: cwn kxq dea arg
mix: uit etj
gyr: ary
rhg: xsj qhx hin
evu: you tnx
kvv: ljj geb ugw xbn vkz mai lek ohl lwg xtg gvx rbb
lhd: you tnx
gfd: scj yvl uyz gbw
ehp: etj mqr
shi: fhu zjk
wwq: onu gxp ake tql ubw htz qck txr bji
vdw: cll pho
ure: hin qhx xsj kvv qef
bvr: jwe agw
yrl: yef few pju
ekh: etj
sku: out
wru: qck gxp zpr nqi ubw ygg ytl txr vrh qib lxv tql oyh
flj: kum hkm
wka: otc usl dgh
kxt: xbx
zco: lcm agd fob
roc: jyw hun yie
hvl: bbw rya nao
gte: qja ihe
vrh: cxb fwz wlp
nsa: ymg you
khm: hkm zho bjz
san: adb xfj
xfy: xah biu zps
afe: zlo mow ujt
jsc: scs lvn
rab: ucd cpj
zly: ezv rzd
xsb: zym
jgo: psz rwb
zil: mkk liq qju dry
ieb: kkr yjk tox uyc
tuh: zmf pus
dfh: ldl lxb yfl uri plv stz vgq
aar: zai hut xmm wzc
ebw: aym cvt
ztr: tnx ymg you
bzq: hvt
ukj: qor
zqs: wru
pos: pne
cll: joj ior bga
fft: bnt bqw urh nna
uah: xhz mqs
zdr: wwq
vcl: dnr zsg
lpt: hpc jvi bpv
uvq: aqt bzq cah
umf: hpp
tql: uzd yka
cbb: gks iio uvq taz ldb kni lvo vhr vcq soe fvo gdv gnp ian bug xmz ggi srq aga
hpp: uit etj mqr
sol: iyi csl rab ouy
wcp: vab vom dfh rpz
hjc: pho
krm: ttn cne ikt
qge: ggi kkh aga srq fvo gnp nbd vhr vcq lvo gks iio ldb
sor: etj mqr
ngf: hbl jmh
ipm: xsj qef
jnj: ovx jup znc
trx: gdg wwq eiu
aym: kvv
lxv: umf
tox: llx
ldx: gzh inz jyv
mrr: rrv xcb uen evh
kmi: uit etj mqr
kxq: tnx
ekb: kmi pwz
qij: era jqq jal mgp
bzj: mqr
kni: cah
xuy: rzd eng ezv
lju: uit etj
aim: wfh iiq cxk
joj: out
dlr: xcj
iwd: gdg
cni: gjx gyr pvu
bug: nqw aqt bzq cah
nlq: yrx pfp cpj
yvl: yfw
ggi: azc
fvo: ven pos ebw snm
dea: tnx you
arg: ymg you
otc: xsj hin kvv
okq: san mgp
nig: ufo jof
zxd: pvu nse gjx
jfh: vxj wdb cwi
ytl: gte cxb
wdz: zjk
zmv: out
gzg: nav
uaa: csl nlq
nse: mts ary
agw: rpz heu dfh vom vab
ngl: lft lvn
azc: jht
yef: kvv
ayw: axm kkx zhp
wwz: xkl kmi ehp
hny: mrp
xfu: kpy xbx
ihk: qxu xfy quu
egh: ymg tnx
wrt: vnz sjx
unu: zai hut xmm
kyd: out
yfw: ixv
yog: eiu gdg wru
vno: uti jyw hun
ylp: zna
adb: tza uiy
bqw: jwe
hpc: pbg
aqe: mdf nsc mzb oar ure
lfa: jip
usl: qef kvv hin
pbg: wru gdg eiu
ddk: dlr ftz
plv: jmh
skj: srq ggi xmz bug ian tuh gdv soe lvo vhr vcq nbd kni taz ndb iio uvq
lxy: rrv evh uen
trw: pcr cvt rhg
skw: wwq gdg wru
hut: gdg wwq
pju: qhx hin qef kvv
mng: iiq wfh cxk ndv
xss: dll yrl
nna: jwe
euw: vxu
glz: bqe byz jht oya
drb: sub eqb
csl: cpj pfp yrx
ake: zxc
axm: trg zrr fxh
tnx: tej gss itd phr wdz ueb tsx agv ukj
aga: glz
ikt: txx skw trx
zkn: wru gdg wwq
uht: dub ssu lhd
fvq: pho
rbb: tmi nis
tgs: vsv
uqt: uit mqr
fhu: aqy jvg
ndb: zmf
sub: wyc
qld: mix lah
gks: trw ebw snm pos ven
qkm: dub lhd
bbw: roc
bqe: usl dgh
rtq: zil
vgq: vuq
ghy: fhu qor
wfh: dfh
oar: hin xsj kvv qef
xrh: vab dfh heu rpz
bzo: wwq eiu gdg
fya: jup ovx
ufo: gir xrh mhd ixn
yrb: cwi
tpe: out
wxr: cve mhf
kkx: fxh fft
heu: zxd azj rit egf cni ngf yfl lpt
vjm: liq qju mkk
tyi: bzj ekh lmc
cpj: ljo xbq
ozm: vxu
nsc: qef kvv xsj qhx
tfu: quu xfy cld
vkr: iwd yog zdr zkn
xmz: azc zcj
dvc: mkk vvu
lxb: mhx xfu
xcj: skw trx
foc: znc ovx
ihe: wdb euw ozm cwi
ljj: hij ufo jof fmq air
qup: ipm
lvo: azc glz zcj
jal: mbz utd
kmy: znc ovx
rjt: mow ujt zlo mrp
mzc: xmm wzc zai
xhz: bbw nao hkt rya aej
egf: xfu mhx jsm ica
zai: gdg eiu wwq
gzk: odw wxr
dcx: dfh heu vab
nha: jnj kmy fya ztw
xaj: qkm uch
zsg: eiu
cbd: enn seo
esm: lmc uqt
svr: thc qge skj epj cbb
jqq: xfj mbz adb utd oas
gbw: yfw
snm: aym rhg pne
dgh: xsj qhx hin qef
ged: fhu qor
ixn: vab rpz dfh
yrg: wxl mng aim
bjz: out
jof: ixn xrh gir
llx: ktw geh evu
nqi: kaj vdg mis ylp
znc: out
xsj: fkg mai gzg vly vkz nig xtg ayw lwg ohl iid
jvv: qhx kvv qef
eiu: htz qck nvk gxp ygg zpr ubw ytl qib vrh onu lxv tql
gcd: plb wcp fic inq
wwp: rjt weo hzt afe
oyh: uzd qld boi umf yka
geb: nis
hah: wxr
tsx: qij
zho: out
thc: gks uvq iio ndb taz kni nbd vhr vcq soe tuh fvo gnp ian bug xmz ggi kkh aga srq
mmm: hbl
tsa: scj jgo gbw uyz
dns: inq fic qgs
mai: axm bhw zhp
vhr: xss aqt cah bzq
uzd: lah hpp lju
dac: arg cwn kxq dea
epj: xmz bug srq aga gnp gdv tuh ian lvo vcq nbd kni soe uvq gks ldb taz
vvu: hjc
yrx: nsa
iql: out
ftz: ttn cne soc xcj
fkg: nis ihk tfu tmi
vuq: scs
mdt: zkn zdi yog iwd zdr
bhw: fxh
ktw: you
wyc: ipm
rwb: oez
gbl: ngl jsc
was: uit mqr
vom: gzb xoc epr ddk lpt vgq cni azj rit nzq ldl wzv lxb vkl ngf yfl lvg gbl uri mmm qmv stz
ujt: ymg
uen: tyj lfw wwz
hhk: plb wcp fic inq
zym: ztr lhd ssu
ybw: out
jvi: dnr zsg
jyw: yar
lek: dns gcd hhk nzh
jsm: kpy xbx
hzt: zlo
svu: mdt vkr
vab: azj rit gzb xoc nzq epr lxb vkl lpt egf
xcb: tyj lfw
vkz: ihk tfu
soe: ldx
fwz: yrb
pus: aqe inz gzh
onu: mrr lxy
dll: huv jrs
lcm: arg dea kxq cwn
rrv: wwz
jup: out
ymp: rzy jez mzz gfd
eau: tox uyc
lzz: yrg ygx mik sqv zpj
cxb: yrb nuh
urh: agw jwe jpj
rjz: vsv
byz: usl otc
zna: rzt xuy
mgp: xfj utd
lfm: aqe
jht: jvv dgh usl
yfm: rzy mzz jez
vxu: etj uit
evh: wwz lfw tyj abr ekb
ven: aym
zpr: vdg kaj
trg: bqw bnt bvr urh nna
hvt: yef jrs huv pju
uiz: zym uch uht qkm
ers: vgj
stz: pvu gjx nse
zmf: gzh inz jyv
ghx: zur jyw hun
hkt: ghx vno roc
azx: aej hkt rya nao
gft: ymg
gzb: xfu
pwz: uit mqr
oya: otc usl jvv
aqt: yrl dll hvt
lfk: hvl azx
htv: iql kyd zmv
npk: swp mah zna
smb: liq qju dry vvu
kum: out
jrq: zym jip uch uht qkm
nio: okq qij
iwe: gdg wwq
soc: txx skw
qef: ayw nig gvx ohl lwg fkg gzg geb
wam: fob ivc lcm agd
xkl: uit
fok: smb zil vjm
gss: exu azx hvl
rpz: lvg vkl lxb stz qmv gbl qul rit azj ldl gzb
qxa: tsa gfd
vcy: jfh nuh yrb ihe qja
qhx: gwh ohl iid xtg geb vly xbn vkz fkg
mqr: qeb zco nnm sol rjz eau ieb xaj cwh tgs kfm hah uiz gzk wwp jig rsf
lvn: aar mzc unu
xbx: eiu wru gdg
jwe: vab vom dfh heu
gvx: lzz
ljo: ymg you tnx
rzd: mqr etj uit
ixv: uce zmv bpy kyd
cne: skw gmc trx
pcr: kvv xsj qhx hin
uch: dub ztr
few: qef xsj
scs: mzc aar
eng: etj mqr
cvt: xsj kvv qef
zur: btv
yar: out
qmn: wfh
tfc: xcb gzu
iio: zcy pus
xtg: dns gcd hhk
nzq: nse gjx gyr
gdg: txr ytl ygg ubw zpr nqi onu oyh tql lxv qib vrh qck htz gxp ake nvk
vdg: mah
jyv: oar mzb nsc mdf
ucd: nsa ptx ljo
qib: tfc mrr
uyc: qsh saf ndq
ubw: gte wlp vcy cxb
htz: tyi
ldb: pos trw
nvk: boi
seo: sch wrt qup
qul: epe nvg dlr krm
mik: qmn wxl
liq: vdw mjj hjc fvq
plb: vom
pho: ybw ior bga joj
ezv: etj
pne: xsj qhx kvv
ymg: shi lhk uah rtq ged qxa ghy fok yfm
srq: vdy
jcf: nha dnz
jrs: hin
xfj: tza edj uiy
jmh: zqs iwe ulh bzo
ttn: irv txx trx
nuh: vxj euw ozm cwi
bnt: jpj
cru: ulh iwe
tmi: cld quu xfy
gzh: mzb ure mdf nsc
vgj: foc ztw jnj kmy fya
weo: zlo
uti: btv yar sku
gir: vab vom dfh heu rpz
hbl: bzo zqs iwe
yfl: pvu nse
mts: taw nmk
cld: dcx xah uby
lah: mqr etj
kpy: eiu wwq
yka: lah hpp lju
ary: taw mdt nmk xlq
iid: ufo air
gjx: svu ary
gxp: kaj mis ylp npk
cxk: heu
biu: vom rpz heu dfh
dnz: fya foc
rzt: eng
mis: mah zna
fff: ygx mik
eqb: sch qup wyc
dry: vdw mjj fvq iqw
lct: mqr etj
wlp: nuh jfh ihe yrb
bra: tpe bga joj
sjx: kvv qef qhx xsj hin
mow: tnx ymg
quu: uby dcx xah
vdy: sub enn eqb seo
wdb: sor was vxu
epr: vuq ngl jsc
ugw: ufo fmq jof air
hij: gir
iqw: pho bra
